------------------------------------
|                                  |
|  x    |                   |      |
|       |       |           |      |
|       |       |           |      |
|       |       |           |      |
|                                  |
|        |                         |
|        |               |         |
|        |               |         |
|        |       x       |    x    |
|                        |         |
------------------------------------